8 8
********
*O     *
****** *
*      *
* ******
*      *
*      *
********
7 2
LRTLBTRBTRL